11111111111
10P000C0001
10000000001
1001C101001
10101C10001
100000000C1
100C0000001
11110111001
100C0001E01
11111111111
