1111111111111111111111111111111111
10000000000000000P1111111111111111
1110111111111111101111111111111111
1100000111000001111111111111111111
11111100000111011011111111111111E1
1C00011111100000000000000000000001
1111000000001010101111101111111111
1111111111111111101111111111111111
11111111111111111C1111111111111111
1111111111111111111111111111111111
