11111
10P11
10001
1C1E0
11111
